111111111
10C000C01
1PE0000C1
1000CC001
100000001
100000101
100000C01
111111111