111111111111111111111
10000000E0C00000P0001
111111111111111111111