1111111111
1000000001
10000P0011
100E00C011
1111111111